#######################################
# Syntax Coloring Map For Twitter
#######################################

#######################################
# Datatypes (KEYWORD1)
#######################################

LCD	KEYWORD1
GLCD	KEYWORD1
uint8_t	KEYWORD1
uint16_t	KEYWORD1
int8_t	KEYWORD1
int16_t	KEYWORD1
PSTR	KEYWORD1
PROGMEM	KEYWORD1

#######################################
# Methods and Functions (KEYWORD2)
#######################################

bitblt	KEYWORD2
bitblt_P	KEYWORD2
clearScreen	KEYWORD2
demo	KEYWORD2
drawBox	KEYWORD2
drawCircle	KEYWORD2
drawLine	KEYWORD2
drawLines	KEYWORD2
drawLines_P	KEYWORD2
drawMode	KEYWORD2
drawPixel	KEYWORD2
drawPolygon	KEYWORD2
drawPolygon_P	KEYWORD2
drawRoundedBox	KEYWORD2
drawSprite	KEYWORD2
echo	KEYWORD2
echoWait	KEYWORD2
eraseBlock	KEYWORD2
eraseBox	KEYWORD2
factoryReset	KEYWORD2
fillBox	KEYWORD2
fontMode	KEYWORD2
loadSprite	KEYWORD2
loadSprite_P	KEYWORD2
nextLine	KEYWORD2
printNum	KEYWORD2
printStr	KEYWORD2
put	KEYWORD2
putcmd	KEYWORD2
putstr	KEYWORD2
putstr_P	KEYWORD2
query	KEYWORD2
ready	KEYWORD2
reset	KEYWORD2
restoreDefaultBaud	KEYWORD2
reverseMode	KEYWORD2
set	KEYWORD2
setBacklight	KEYWORD2
setBaud	KEYWORD2
setCRLF	KEYWORD2
setGraphics	KEYWORD2
setHome	KEYWORD2
setPixel	KEYWORD2
setScroll	KEYWORD2
setX	KEYWORD2
setXoff	KEYWORD2
setXon	KEYWORD2
setXY	KEYWORD2
setY	KEYWORD2
toggleReverseMode	KEYWORD2
toggleSplash	KEYWORD2
updateBacklight	KEYWORD2
waitc	KEYWORD2
write	KEYWORD2
write_P	KEYWORD2
xdim	KEYWORD2
ydim	KEYWORD2

#######################################
# Constants (LITERAL1)
#######################################
GLCD_CHAR_CMD	LITERAL1
GLCD_CHAR_XON	LITERAL1
GLCD_CHAR_XOFF	LITERAL1
GLCD_MODE_NORMAL	LITERAL1
GLCD_MODE_REVERSE	LITERAL1
GLCD_MODE_OR	LITERAL1
GLCD_MODE_XOR	LITERAL1
GLCD_MODE_NAND	LITERAL1
GLCD_MODE_FILL	LITERAL1
GLCD_MODE_CENTER	LITERAL1

GLCD_CMD_CLEAR_SCREEN	LITERAL1
GLCD_CMD_SET_BACKLIGHT	LITERAL1
GLCD_CMD_DRAW_CIRCLE	LITERAL1
GLCD_CMD_DEMO	LITERAL1
GLCD_CMD_ERASE_BLOCK	LITERAL1
GLCD_CMD_FILL_BOX	LITERAL1
GLCD_CMD_CHANGE_BAUD_RATE	LITERAL1
GLCD_CMD_DRAW_ROUNDED_BOX	LITERAL1
GLCD_CMD_FONT_MODE	LITERAL1
GLCD_CMD_DRAW_LINE	LITERAL1
GLCD_CMD_DRAW_MODE	LITERAL1
GLCD_CMD_DRAW_BOX	LITERAL1
GLCD_CMD_DRAW_PIXEL	LITERAL1
GLCD_CMD_DRAW_LINES	LITERAL1
GLCD_CMD_REVERSE_MODE	LITERAL1
GLCD_CMD_TOGGLE_SPLASH	LITERAL1
GLCD_CMD_DRAW_SPRITE	LITERAL1
GLCD_CMD_UPLOAD_SPRITE	LITERAL1
GLCD_CMD_BITBLT	LITERAL1
GLCD_CMD_ECHO	LITERAL1
GLCD_CMD_SET_X_OFFSET	LITERAL1
GLCD_CMD_SET_Y_OFFSET	LITERAL1
GLCD_CMD_DRAW_POLYGON	LITERAL1
GLCD_CMD_SET	LITERAL1
GLCD_CMD_QUERY	LITERAL1
GLCD_CMD_FACTORY_RESET	LITERAL1
GLCD_CMD_RESET	LITERAL1

GLCD_CMDX_GRAPHICS_ON	LITERAL1
GLCD_CMDX_GRAPHICS_OFF	LITERAL1
GLCD_CMDX_SET_BACKLIGHT	LITERAL1
GLCD_CMDX_DRAW_CIRCLE	LITERAL1
GLCD_CMDX_FILL_BOX	LITERAL1
GLCD_CMDX_DRAW_ROUNDED_BOX	LITERAL1
GLCD_CMDX_DRAW_LINE	LITERAL1
GLCD_CMDX_DRAW_BOX	LITERAL1
GLCD_CMDX_DRAW_PIXEL	LITERAL1
GLCD_CMDX_DRAW_LINES	LITERAL1
GLCD_CMDX_REVERSE_MODE	LITERAL1
GLCD_CMDX_SET_XY_OFFSET	LITERAL1
GLCD_CMDX_DRAW_POLYGON	LITERAL1

GLCD_ARG_PROGMEM	LITERAL1
GLCD_ARG_SIZEOF	LITERAL1
GLCD_ARG_XY_LIST	LITERAL1
GLCD_ARG_SPRITE_WH	LITERAL1
GLCD_ARG_SPRITE	LITERAL1
GLCD_ARG_TYPE_MASK	LITERAL1

GLCD_CMD_SET_CHECKBYTE	LITERAL1

GLCD_ID_MAGIC	LITERAL1
GLCD_ID_BAUDRATE	LITERAL1
GLCD_ID_BACKLIGHT	LITERAL1
GLCD_ID_SPLASH	LITERAL1
GLCD_ID_REVERSE	LITERAL1
GLCD_ID_DEBUG	LITERAL1
GLCD_ID_CRLF	LITERAL1
GLCD_ID_XON_POS	LITERAL1
GLCD_ID_XOFF_POS	LITERAL1
GLCD_ID_SCROLL	LITERAL1
GLCD_ID_LARGE_SCREEN	LITERAL1
                           
GLCD_ID_VERSION_MAJOR	LITERAL1
GLCD_ID_VERSION_MINOR	LITERAL1
GLCD_ID_EEPROM_SPRITE_SIZE	LITERAL1
GLCD_ID_EEPROM_SPRITE_NUM	LITERAL1
GLCD_ID_RAM_SPRITE_SIZE	LITERAL1
GLCD_ID_RAM_SPRITE_NUM	LITERAL1
                           
GLCD_ID_X_DIMENSION	LITERAL1
GLCD_ID_Y_DIMENSION	LITERAL1
                           
GLCD_ID_ESPRITE_WIDTH_0	LITERAL1
GLCD_ID_ESPRITE_HEIGHT_0	LITERAL1
